1111111111111
10010000CC001
1000011111001
1P0011E000001
1111111111111