1111111111111
10010111CC101
10C1011111001
1P100000E1001
1111111111111