1111111111111
10010C0000101
1001011111001
1P0000000E001
1111111111111