




                  11111111111111
                  1CC1CC0CCCCC11
                  11CCCC111C1111       
                  1PCCC11EC0CC11 
                  11111111111111
