1111111111111
1CC1CCCCCC1C1
1CC1C11111CC1
1PCCCCCCCECC1
1111111111111