1111111111111
1CC1CCCCCC101
1CC1C11111001
1PCCCCCCCE001
1111111111111