


        111111
        100001
        1PC111
        10E101
        111111






