
                                        
      1111111111111     
      1001000000001
      1000C11110101   
      1P100EC001101  
      1111111111111    


       
        
                   
                        