
                                        
      1111111111111     
      1001000CC0001
      1000C11110101   
      1P10000001101  
      1111111111111    


       
        
                   
                        